#############################
#############################
######NNNNNNNNNNNNNNNN#######
#############NN##############
#@DDDDDDDDS##NN#####NN#######
###NNN####S##NN##DDDDDDS#####
###N#N####S######W#####S#NNN#
###NNN####DDDDDDDW##NN#S#N#N#
################NN##NN#S#NNN#
#######NNNNN########NN#S#####
###########N#######NN##S####N
###DDDDDD$#NNNNNNNNN###DDDDS#
###W#######NNNNNNNNN#######S#
###W#####################NNS#
###W#######SAAAAAAAAAAAAAAAA#
###W##NNN##S#NNN#############
###W##NNN##S##NN#############
###W##NNN##S##NN#NNNNN##NN###
###W###N###S##N##NNNNN##NN###
###W###N###S######NNNN##NNNNN
###W##NNN##S################N
###W##NNN##DDDDDDDDDDDDDDDDSN
###W##NNN##################SN
###W#############NNN#######SN
###WNNNNNNN################S#
###WAAAAAAAAAAAAAAAAAAAAAAAA#
##############NN#############
######NNN##############NNN###
#############################
#############################
AAAAA
AAAAAB
AAAABBB
AAABBBBB
AABBBBBBBBBB