#############################
#############################
#############################
#############################
#############################
#############################
#############################
#######$AAAAAAAAAAAAAAAAA####
########################W####
########################W####
######################DDW####
######################W######
######################W######
####DDDDDDDDDDDDDDDDDDW######
####W########################
####W########################
####WAAAAA###################
#########W###################
##DDDDS##W###################
##W###S##W###################
##W###DDDW###################
##@##########################
#############################
#############################
#############################
#############################
#############################
#############################
#############################
#############################
AAAAAAAAA